#########################################################
#.......................................................#
#..###..#..#....#...#...#...............................#
#...#...#..#....#....#.#................................#
#...#...#..#....#.....#.................................#
#...#...#..###..###...#.................................#
#.......................................................#
#.......................................................#
#.......................................................#
#..........#+++++++#....................................#
#.........###########...................................#
#..........#.......#....................................#
#.......................................................#
#.......................................................#
#.......................................................#
#.......................................................#
#.......................................................#
#.......................................................#
#.......................................................#
#.......................................................#
#.......................................................#
#.......................................................#
#..#....................................................#
#.......................................................#
#.......................................................#
#.......................................................#
#.......................................................#
#.......................................................#
#.......................................................#
#.......................................................#
#.......................................................#
#.......................................................#
#..@....................................................#
#########################################################
