################################
#..............................#
#..............................#
#..............................#
#.......................#......#
#..............................#
#..............................#
#..............................#
#..............................#
#..........#+++++++#...........#
#.........###########..........#
#..........#.......#...........#
#..............................#
#..............................#
#..............................#
#..............................#
#..............................#
#..............................#
#..............................#
#..............................#
#..............................#
#..@...........................#
#..............................#
################################
