####################################################################################################################
#......................................#++#........................#######....................................#+#..#
#......................................#++#.....................####.....####.................................#+#..#
#......................................#++##########...........##...........##................................#+#..#
#......................................##++++++++++##.........##.............##...............................#+#..#
#.......................................##########++#.........#...............................................#+#..#
#................................................##+#.........#..............................................##+#..#
#.................................................#+#.........#................................###############++#..#
#.................................................###.........#.....#...#........................++++++++++++++##..#
#.............................................................##..|...|...|..##............#####################...#
#..............................................................##+++++++++++##............v........................#
#...............................................................####+++++####......................................#
#...............................................#.....#............#######........###.........###..................#
#...............................................#.....#...........................#.#.........#.#..................#
#...............................................#.....#.............................#.........#....................#
#...............................................#.....#.............................##........#....................#
#...............................................##....#.............................#.........#....................#
#............................o..................#.....#...............#...#.........#.........#....................#
#...............##################...###........#.....#...............#...#.........#.........#....................#
#.............o##.....##.........#...#..........#.....#.....######....#...#...#########.......#....................#
#.............##.......##........#...#..........#....##...............#...#...#...............#....................#
#.....@.......#.........#........#...#..........#.....#...............#...#...#...............#....................#
#....###......#.........#........#...#..........#.....#...............#...#####...######......#....................#
#...##.#.....##.........#.......##...##.........#.....#...............#...........#.#.........#....................#
#++++#.#++++++#.........#++++++##.....##++++++++##....#++++++++++.....#.....=.....#.#.........#....................#
#++++#.#++++++#.........#+++++##.......##########.....#+++++++##+.....#############.##.......##....................#
#+++##.#+++++##.........#+++++#......................##++++++##.+....................##.....##.....................#
#++++#.#++++++#.........#+++++#.....................##++++++##..+.....................#######......................#
#++++#.#++++++#.........#+++++##.......##############++++++##...+..................................................#
#++++#.#++++++#.........#++++++#########++++++++++++++++++##....+..................................................#
#++++#.#++++++#.........#++++++++++++++++++++++++++++++++##.....+..................................................#
####################################################################################################################
